TTTTTTTTTTTTTTTTTTTTTTTTTTTTTTTTTTTTTTTTTTTTTTTTTTTTTTTTTTTTTTTTTTTTTTTTTTTTTTTTTTTTTTTTTTTTTTTTTTTTTTTTTTTTTTTTTTTTTTTTTTTTTTTTTTTTTTTTTTTTTTTTTTTTTTTTTTTTTTTTTTTTTTTTTTTTTTTTTTTT#
TTTTTTTTTTTT.........TTTTTTTTTTTTTTTTTTTTTTTTTTTTTTTTTTTTTTTTTTTTTTTTTTTTTTTTTTTTTTTTTTTTTTTTTTTTTTTTTTTTTTTT................TTTTTTTTTTTTTTTTTTTTTTTTTT..................TTTTTTTTTTT#
TTTTTTT----..............TTTTTTTTTTTTTTTTTTTTT....................TTTTTTTTTTTTTTTTTTTTTTTTTTTTTTTT...................................TTTTTTTTTTTTTT............................TTTTT#
TTTTT---@----......................TTTTTTTT...........................TTTTTTTTTT................................................................................................TTTT#
TTTT....------..................................................................................................................................................................TTTT#
TTTT.......---.................................................................................................................................................................TTTTT#
TTT.........---................................................................................................................................................................TTTTT#
TTT..........---...............................................................................................................................................................TTTTT#
TTT............---............................................................................................................................................................TTTTTT#
TT...............---........................................................................................................................................................TTTTTTTT#
TT................---......................................................................................................................................................TTTTTTTTT#
TTT...............---......................................................................................................................................................TTTTTTTTT#
TTT................---..############################.........................................................................................................................TTTTTTT#
TTT..................---.....#---------------------#............................................................................................................................TTTT#
TTTT..................-------_---------------------#.............................................................................................................................TTT#
TTTTT...............#..------_---------------------#............................................................................................................................TTTT#
TTTTT...............#..--....#---------------------#...........................................................................................................................TTTTT#
TTTTTT..............###__##########_###########################...............................................................................................................TTTTTT#
TTTTTT..............#-------------_---------_-----------------#...............................................................................................................TTTTTT#
TTTTTT..............#-F-----------#---------#-----------------##############...................................................................................................TTTTT#
TTTTTT..............#-------------#---------#-----------------_------------#....................................................................................................TTTT#
TTTTTT..............###############---------#-----------------_------------#.....................................................................................................TTT#
TTTTT........................######H####################_######------------#......................................................................................................TT#
TTTTT........................#----------#-------#-------------#------------#......................................................................................................TT#
TTTT.........................#----------#-------##FF----------##############.....................................................................................................TTT#
TTTT.........................############-------##FF----------#.................................................................................................................TTTT#
TTT.....................................#-------_-------------#................................................................................................................TTTTT#
TT......................................#######################...............................................................................................................TTTTTT#
TT............................................................................................................................................................................TTTTTT#
TT...........................................................................................................................................................................TTTTTTT#
TTT.........................................................................................................................................................................TTTTTTTT#
TTTTT.......................................................................................................................................................................TTTTTTTT#
TTTTTTT.....................................................................................................................................................................TTTTTTTT#
TTTTTTTT....................................................................................................................................................................TTTTTTTT#
TTTTTTTT...................................................................................................................................................................TTTTTTTTT#
TTTTTTTTT..................................................................................................................................................................TTTTTTTTT#
TTTTTTTTT..................................................................................................................................................................TTTTTTTTT#
TTTTTTTTTT..................................................................................................................................................................TTTTTTTT#
TTTTTTTTTTT...................................................................................................................................................................TTTTTT#
TTTTTTTTTTT.....................................................................................................................................................................TTTT#
TTTTTTTTTT.......................................................................................................................................................................TTT#
TTTTTTTTTT.......................................................................................................................................................................TTT#
TTTTTTTTT.......................................................................................................................................................................TTTT#
TTTTTTTT......................................................................................................................................................................TTTTTT#
TTTTTTT.....................................................................................................................................................................TTTTTTTT#
TTTTTTT.................................................................................................................................................................TTTTTTTTTTTT#
TTTTTTTT...............................................................................................................................................................TTTTTTTTTTTTT#
TTTTTTTT...............................................................................................................................................................TTTTTTTTTTTTT#
TTTTTTTTTT........................................................................TTTTTTT............................................................................TTTTTTTTTTTTTTT#
TTTTTTTTTTTTT..........................................................TTTTTTTTTTTTTTTTTTTTTT...................................................................TTTTTTTTTTTTTTTTTTTT#
TTTTTTTTTTTTTTTTTTTT.....................................TTTTTTTTTTTTTTTTTTTTTTTTTTTTTTTTTTTTTTTTTTTT................TTTTTTTTTTTTTTTTTTTT...............TTTTTTTTTTTTTTTTTTTTTTTTTTTT#
TTTTTTTTTTTTTTTTTTTTTTTTTTTTTTTTTTTTTTTTTTTTTTTTTTTTTTTTTTTTTTTTTTTTTTTTTTTTTTTTTTTTTTTTTTTTTTTTTTTTTTTTTTTTTTTTTTTTTTTTTTTTTTTTTTTTTTTTTTTTTTTTTTTTTTTTTTTTTTTTTTTTTTTTTTTTTTTTTTTT#
TTTTTTTTTTTTTTTTTTTTTTTTTTTTTTTTTTTTTTTTTTTTTTTTTTTTTTTTTTTTTTTTTTTTTTTTTTTTTTTTTTTTTTTTTTTTTTTTTTTTTTTTTTTTTTTTTTTTTTTTTTTTTTTTTTTTTTTTTTTTTTTTTTTTTTTTTTTTTTTTTTTTTTTTTTTTTTTTTTTT#
